1111111111111111111111111111111
10P0000001000000000000000100001
1000000001000000000000000000001
100000C001000000000000000111111
1000000001000000000000000000001
1000000000000000000000000000001
1111111111000000000000000000001
1000000000000000000000000000001
100000C000000011111000000000001
1000000000000000000000000000001
1000000000000000000000000000001
10000000000000C0000C00000000001
1000000000000000000000000000001
1000000000000000000000000000001
10000000000C0000000000000000001
100000C000000000000000000000001
100000000000000000000C000000001
1000000000111111000000000000001
1000000000000000000000000000001
10000000000000000000000000E0001
10000000000000000000C0000000001
1000000001000000000000000000001
1111111111111111111111111111111
