1111111111111111111111111111111
10P0000001000000000000000100001
100000000100000000000000000E001
1000000001000000C00000000111111
1000000001000000000000000000001
1000000001000000000000000000001
1000000C0100000C000000000000001
1000000000000000000000000000001
1000000000000000000000000M00001
1000000C0000000C000000000000001
1000000000000000000000000000001
1000000000000000000000000000001
1000000C0000000C000000000000001
100000000000000000000M000000001
1000000000000000000000000000001
1000000C0000000C000000000000001
10000000000000000000000M0000001
1000000000000000000000000000001
1000000C0000000C000000000000001
1000000000000000000000000000001
1000000000000000000000000000001
1000000C0100000C000000000000001
1111111111111111111111111111111
