1111111111111111111111111111111111111111111111111
10P0000001000000000001000000000000000000001000001
1001111111111001111001111001111001111001111111001
1000001000000001000000001000001001000001000000001
1111001001001111111001111111111111111001001111001
1000000001000001000001000001000001000000001000001
1001001111111111111001001111001001111111111MM1111
1001000001001000000000001001001000MMMMMMMM1MM1001
1001111111001111001001001001111111111MM1MM1MM1001
1001000000000001001001001000001001MMMMM1MM1MM0001
1001111111001111111001001001111001111111MM1MM1001
1000000000000000001001000000000001MM1MMMMM1MM1001
1001111111001111111111111111001111MM1111MM1MM1111
1001000000001001000001000001000001000000001000001
1111111001111001111001001111111001001111001001001
1000000000C01001000001000000000001001000001001001
1111111001111001001001111001001111001001111111001
1000000001001000001000001001001001001001000001001
1111111111001111111001001001111001111001111001001
1000001000000000000001000001000001001000000000001
1111001001001001111001111001001001001111111111001
1000001001001001001000001000001000000001001000001
1001111111001001001111111111001111111111001001111
1000000001001001000001001001001000000001001001001
1001111111MM1111001111001001111001111111001001001
1000MMMMMMMMM000001001000000000C00000000000000001
1001MM1MM1111111111001001111001001111111111111111
1001MM1MMMMMM000000001001000001001000000001000001
1111111MM1111111111001111111001001001001111111001
1000000001001000000001000000001000001000000001001
10011110010011110010C1001111001111111111111111001
10010000000010000010000010000000000000000000000E1
1111111111111111111111111111111111111111111111111